NO 255,0,255
SO 0,255,0
WE 255,0,0
EA 0,0,255

F 255,255,255
C 0,0,0

11        1111111111111111111111111
11        1000000000110000000000001
11        1011001001110000000000001
11        100101 100000000000000001
11111111111011001001110000000000001
11100000000011000001110111111111111
1111110111111111011100000010001
1111110111111111011101010000001
1111000000110101011100000010101
11100000000000000011000000100011
111000000000000000110101001000001
1111000001110101011111011100N0011
1111110111 1110101 1011110100001
1111111111 1111111 111111111111